00000000000000000000
00000011100000000000
00000014100000000000
00011113100000000000
00014235111000000000
00011132341000000000
00000121111000000000
00000141000000000000
00000111000000000000
00000000000000000000
00000000000000000000
00000000000000000000
00000000000000000000
00000000000000000000
00000000000000000000
00000000000000000000
00000000000000000000
00000000000000000000
00000000000000000000
00000000000000000000